##A    #############
## ### #############
##   # #############
#### # #     #######
#### #   ### #######
#### #######  ##   #
#### ######## ## # #
####  #######    # #
##### ############ #
##### ############ #
#     ############ #
# ################ #
# ##########       #
#      ##### #######
############   #####
##############B#####
